VISAKHAPATNA,ASHOK LEYLAND,MOT-PRD-003,ASHOK LEYLAND 3120,AL U 3120 BS VI,PRTL_14517,5660,2,DIESEL,3936000,3739200,3345600,3148800,2755200,2361600,1968000,1771200,1574400,1377600,1180800,984000,688800,585480,380562,323478,226435,VEH_MANF_023,PRTL_14517,MFT2,31000
VISAKHAPATNA,FORCE MOTOR,MOT-PRD-005,TRAVELLER,TRAVELLER (C) (BSIV) SMOOTH,PRTL_14526,2596,21,CNG,1860000,1767000,1581000,1488000,1302000,1116000,930000,837000,744000,651000,558000,465000,325500,276675,179839,152863,107004,VEH_MANF_097,PRTL_14526,MFT3,0
VISAKHAPATNA,TATA,MOT-PRD-003,TATA T.7 ULTRA ,TATA T.7 ULTRA DCR35CBC 100B6MS,PRTL_14515,2596,2,DIESEL,1595000,1515250,1355750,1276000,1116500,957000,797500,717750,638000,558250,478500,398750,279125,237256,154216,131084,91759,VEH_MANF_011,PRTL_14515,MFT2,7490
VISAKHAPATNA,TATA,MOT-PRD-003,TATA T.7 ULTRA ,TATA T.18 ULTRA SLR56CBC BSVI,PRTL_14516,5055,2,DIESEL,1635000,1553250,1389750,1308000,1144500,981000,817500,735750,654000,572250,490500,408750,286125,243206,158084,134371,94060,VEH_MANF_011,PRTL_14516,MFT2,17600
VISAKHAPATNA,EICHER,MOT-PRD-003,EICHER PRO 2110 XPT,PRO 2110XPT E FET PTO BSVI LY PRM,PRTL_14527,3760,3,DIESEL,2345000,2227750,1993250,1876000,1641500,1407000,1172500,1055250,938000,820750,703500,586250,410375,348819,226732,192722,134905,VEH_MANF_034,PRTL_14527,MFT2,13000
VISAKHAPATNA,SCANIA,MOT-PRD-003,G 500 XT 8X4 HEAVY,G 500 XT 8X4 HEAVY,PRTL_14521,12742,2,DIESEL,5464000,5190800,4644400,4371200,3824800,3278400,2732000,2458800,2185600,1912400,1639200,1366000,956200,812770,528301,449056,314339,VEH_MANF_141,PRTL_14521,MFT2,35000
EAST KAMENG,ASHOK LEYLAND,MOT-PRD-003,ASHOK LEYLAND 3120,AL U 3120 BS VI,PRTL_14517,5660,2,DIESEL,3936000,3739200,3345600,3148800,2755200,2361600,1968000,1771200,1574400,1377600,1180800,984000,688800,585480,380562,323478,226435,VEH_MANF_023,PRTL_14517,MFT2,31000
EAST KAMENG,FORCE MOTOR,MOT-PRD-005,TRAVELLER,TRAVELLER (C) (BSIV) SMOOTH,PRTL_14526,2596,21,DIESEL,1860000,1767000,1581000,1488000,1302000,1116000,930000,837000,744000,651000,558000,465000,325500,276675,179839,152863,107004,VEH_MANF_097,PRTL_14526,MFT2,0
EAST KAMENG,TATA,MOT-PRD-003,TATA T.7 ULTRA ,TATA T.7 ULTRA DCR35CBC 100B6MS,PRTL_14515,2596,2,DIESEL,1595000,1515250,1355750,1276000,1116500,957000,797500,717750,638000,558250,478500,398750,279125,237256,154216,131084,91759,VEH_MANF_011,PRTL_14515,MFT2,7490
EAST KAMENG,TATA,MOT-PRD-003,TATA T.7 ULTRA ,TATA T.18 ULTRA SLR56CBC BSVI,PRTL_14516,5055,2,DIESEL,1635000,1553250,1389750,1308000,1144500,981000,817500,735750,654000,572250,490500,408750,286125,243206,158084,134371,94060,VEH_MANF_011,PRTL_14516,MFT2,17600
EAST KAMENG,EICHER,MOT-PRD-003,EICHER PRO 2110 XPT,PRO 2110XPT E FET PTO BSVI LY PRM,PRTL_14527,3760,3,DIESEL,2345000,2227750,1993250,1876000,1641500,1407000,1172500,1055250,938000,820750,703500,586250,410375,348819,226732,192722,134905,VEH_MANF_034,PRTL_14527,MFT2,13000
EAST KAMENG,SCANIA,MOT-PRD-003,G 500 XT 8X4 HEAVY,G 500 XT 8X4 HEAVY,PRTL_14521,12742,2,DIESEL,5464000,5190800,4644400,4371200,3824800,3278400,2732000,2458800,2185600,1912400,1639200,1366000,956200,812770,528301,449056,314339,VEH_MANF_141,PRTL_14521,MFT2,35000
GUWAHATI,ASHOK LEYLAND,MOT-PRD-003,ASHOK LEYLAND 3120,AL U 3120 BS VI,PRTL_14517,5660,2,DIESEL,3936000,3739200,3345600,3148800,2755200,2361600,1968000,1771200,1574400,1377600,1180800,984000,688800,585480,380562,323478,226435,VEH_MANF_023,PRTL_14517,MFT2,31000
GUWAHATI,FORCE MOTOR,MOT-PRD-005,TRAVELLER,TRAVELLER (C) (BSIV) SMOOTH,PRTL_14526,2596,21,DIESEL,1860000,1767000,1581000,1488000,1302000,1116000,930000,837000,744000,651000,558000,465000,325500,276675,179839,152863,107004,VEH_MANF_097,PRTL_14526,MFT2,0
GUWAHATI,TATA,MOT-PRD-003,TATA T.7 ULTRA ,TATA T.7 ULTRA DCR35CBC 100B6MS,PRTL_14515,2596,2,DIESEL,1595000,1515250,1355750,1276000,1116500,957000,797500,717750,638000,558250,478500,398750,279125,237256,154216,131084,91759,VEH_MANF_011,PRTL_14515,MFT2,7490
GUWAHATI,TATA,MOT-PRD-003,TATA T.7 ULTRA ,TATA T.18 ULTRA SLR56CBC BSVI,PRTL_14516,5055,2,DIESEL,1635000,1553250,1389750,1308000,1144500,981000,817500,735750,654000,572250,490500,408750,286125,243206,158084,134371,94060,VEH_MANF_011,PRTL_14516,MFT2,17600
GUWAHATI,EICHER,MOT-PRD-003,EICHER PRO 2110 XPT,PRO 2110XPT E FET PTO BSVI LY PRM,PRTL_14527,3760,3,DIESEL,2345000,2227750,1993250,1876000,1641500,1407000,1172500,1055250,938000,820750,703500,586250,410375,348819,226732,192722,134905,VEH_MANF_034,PRTL_14527,MFT2,13000
GUWAHATI,SCANIA,MOT-PRD-003,G 500 XT 8X4 HEAVY,G 500 XT 8X4 HEAVY,PRTL_14521,12742,2,DIESEL,5464000,5190800,4644400,4371200,3824800,3278400,2732000,2458800,2185600,1912400,1639200,1366000,956200,812770,528301,449056,314339,VEH_MANF_141,PRTL_14521,MFT2,35000
PATNA,ASHOK LEYLAND,MOT-PRD-003,ASHOK LEYLAND 3120,AL U 3120 BS VI,PRTL_14517,5660,2,DIESEL,3936000,3739200,3345600,3148800,2755200,2361600,1968000,1771200,1574400,1377600,1180800,984000,688800,585480,380562,323478,226435,VEH_MANF_023,PRTL_14517,MFT2,31000
PATNA,FORCE MOTOR,MOT-PRD-005,TRAVELLER,TRAVELLER (C) (BSIV) SMOOTH,PRTL_14526,2596,21,DIESEL,1860000,1767000,1581000,1488000,1302000,1116000,930000,837000,744000,651000,558000,465000,325500,276675,179839,152863,107004,VEH_MANF_097,PRTL_14526,MFT2,0
PATNA,TATA,MOT-PRD-003,TATA T.7 ULTRA ,TATA T.7 ULTRA DCR35CBC 100B6MS,PRTL_14515,2596,2,DIESEL,1595000,1515250,1355750,1276000,1116500,957000,797500,717750,638000,558250,478500,398750,279125,237256,154216,131084,91759,VEH_MANF_011,PRTL_14515,MFT2,7490
PATNA,TATA,MOT-PRD-003,TATA T.7 ULTRA ,TATA T.18 ULTRA SLR56CBC BSVI,PRTL_14516,5055,2,DIESEL,1635000,1553250,1389750,1308000,1144500,981000,817500,735750,654000,572250,490500,408750,286125,243206,158084,134371,94060,VEH_MANF_011,PRTL_14516,MFT2,17600
PATNA,EICHER,MOT-PRD-003,EICHER PRO 2110 XPT,PRO 2110XPT E FET PTO BSVI LY PRM,PRTL_14527,3760,3,DIESEL,2345000,2227750,1993250,1876000,1641500,1407000,1172500,1055250,938000,820750,703500,586250,410375,348819,226732,192722,134905,VEH_MANF_034,PRTL_14527,MFT2,13000
PATNA,SCANIA,MOT-PRD-003,G 500 XT 8X4 HEAVY,G 500 XT 8X4 HEAVY,PRTL_14521,12742,2,DIESEL,5464000,5190800,4644400,4371200,3824800,3278400,2732000,2458800,2185600,1912400,1639200,1366000,956200,812770,528301,449056,314339,VEH_MANF_141,PRTL_14521,MFT2,35000
CHANDIGARH,ASHOK LEYLAND,MOT-PRD-003,ASHOK LEYLAND 3120,AL U 3120 BS VI,PRTL_14517,5660,2,DIESEL,3936000,3739200,3345600,3148800,2755200,2361600,1968000,1771200,1574400,1377600,1180800,984000,688800,585480,380562,323478,226435,VEH_MANF_023,PRTL_14517,MFT2,31000
CHANDIGARH,FORCE MOTOR,MOT-PRD-005,TRAVELLER,TRAVELLER (C) (BSIV) SMOOTH,PRTL_14526,2596,21,DIESEL,1860000,1767000,1581000,1488000,1302000,1116000,930000,837000,744000,651000,558000,465000,325500,276675,179839,152863,107004,VEH_MANF_097,PRTL_14526,MFT2,0
CHANDIGARH,TATA,MOT-PRD-003,TATA T.7 ULTRA ,TATA T.7 ULTRA DCR35CBC 100B6MS,PRTL_14515,2596,2,DIESEL,1595000,1515250,1355750,1276000,1116500,957000,797500,717750,638000,558250,478500,398750,279125,237256,154216,131084,91759,VEH_MANF_011,PRTL_14515,MFT2,7490
CHANDIGARH,TATA,MOT-PRD-003,TATA T.7 ULTRA ,TATA T.18 ULTRA SLR56CBC BSVI,PRTL_14516,5055,2,DIESEL,1635000,1553250,1389750,1308000,1144500,981000,817500,735750,654000,572250,490500,408750,286125,243206,158084,134371,94060,VEH_MANF_011,PRTL_14516,MFT2,17600
CHANDIGARH,EICHER,MOT-PRD-003,EICHER PRO 2110 XPT,PRO 2110XPT E FET PTO BSVI LY PRM,PRTL_14527,3760,3,DIESEL,2345000,2227750,1993250,1876000,1641500,1407000,1172500,1055250,938000,820750,703500,586250,410375,348819,226732,192722,134905,VEH_MANF_034,PRTL_14527,MFT2,13000
CHANDIGARH,SCANIA,MOT-PRD-003,G 500 XT 8X4 HEAVY,G 500 XT 8X4 HEAVY,PRTL_14521,12742,2,DIESEL,5464000,5190800,4644400,4371200,3824800,3278400,2732000,2458800,2185600,1912400,1639200,1366000,956200,812770,528301,449056,314339,VEH_MANF_141,PRTL_14521,MFT2,35000
RAIPUR,ASHOK LEYLAND,MOT-PRD-003,ASHOK LEYLAND 3120,AL U 3120 BS VI,PRTL_14517,5660,2,DIESEL,3936000,3739200,3345600,3148800,2755200,2361600,1968000,1771200,1574400,1377600,1180800,984000,688800,585480,380562,323478,226435,VEH_MANF_023,PRTL_14517,MFT2,31000
RAIPUR,FORCE MOTOR,MOT-PRD-005,TRAVELLER,TRAVELLER (C) (BSIV) SMOOTH,PRTL_14526,2596,21,DIESEL,1860000,1767000,1581000,1488000,1302000,1116000,930000,837000,744000,651000,558000,465000,325500,276675,179839,152863,107004,VEH_MANF_097,PRTL_14526,MFT2,0
RAIPUR,TATA,MOT-PRD-003,TATA T.7 ULTRA ,TATA T.7 ULTRA DCR35CBC 100B6MS,PRTL_14515,2596,2,DIESEL,1595000,1515250,1355750,1276000,1116500,957000,797500,717750,638000,558250,478500,398750,279125,237256,154216,131084,91759,VEH_MANF_011,PRTL_14515,MFT2,7490
RAIPUR,TATA,MOT-PRD-003,TATA T.7 ULTRA ,TATA T.18 ULTRA SLR56CBC BSVI,PRTL_14516,5055,2,DIESEL,1635000,1553250,1389750,1308000,1144500,981000,817500,735750,654000,572250,490500,408750,286125,243206,158084,134371,94060,VEH_MANF_011,PRTL_14516,MFT2,17600
RAIPUR,EICHER,MOT-PRD-003,EICHER PRO 2110 XPT,PRO 2110XPT E FET PTO BSVI LY PRM,PRTL_14527,3760,3,DIESEL,2345000,2227750,1993250,1876000,1641500,1407000,1172500,1055250,938000,820750,703500,586250,410375,348819,226732,192722,134905,VEH_MANF_034,PRTL_14527,MFT2,13000
RAIPUR,SCANIA,MOT-PRD-003,G 500 XT 8X4 HEAVY,G 500 XT 8X4 HEAVY,PRTL_14521,12742,2,DIESEL,5464000,5190800,4644400,4371200,3824800,3278400,2732000,2458800,2185600,1912400,1639200,1366000,956200,812770,528301,449056,314339,VEH_MANF_141,PRTL_14521,MFT2,35000
DELHI,ASHOK LEYLAND,MOT-PRD-003,ASHOK LEYLAND 3120,AL U 3120 BS VI,PRTL_14517,5660,2,DIESEL,3936000,3739200,3345600,3148800,2755200,2361600,1968000,1771200,1574400,1377600,1180800,984000,688800,585480,380562,323478,226435,VEH_MANF_023,PRTL_14517,MFT2,31000
DELHI,FORCE MOTOR,MOT-PRD-005,TRAVELLER,TRAVELLER (C) (BSIV) SMOOTH,PRTL_14526,2596,21,DIESEL,1860000,1767000,1581000,1488000,1302000,1116000,930000,837000,744000,651000,558000,465000,325500,276675,179839,152863,107004,VEH_MANF_097,PRTL_14526,MFT2,0
DELHI,TATA,MOT-PRD-003,TATA T.7 ULTRA ,TATA T.7 ULTRA DCR35CBC 100B6MS,PRTL_14515,2596,2,DIESEL,1595000,1515250,1355750,1276000,1116500,957000,797500,717750,638000,558250,478500,398750,279125,237256,154216,131084,91759,VEH_MANF_011,PRTL_14515,MFT2,7490
DELHI,TATA,MOT-PRD-003,TATA T.7 ULTRA ,TATA T.18 ULTRA SLR56CBC BSVI,PRTL_14516,5055,2,DIESEL,1635000,1553250,1389750,1308000,1144500,981000,817500,735750,654000,572250,490500,408750,286125,243206,158084,134371,94060,VEH_MANF_011,PRTL_14516,MFT2,17600
DELHI,EICHER,MOT-PRD-003,EICHER PRO 2110 XPT,PRO 2110XPT E FET PTO BSVI LY PRM,PRTL_14527,3760,3,DIESEL,2345000,2227750,1993250,1876000,1641500,1407000,1172500,1055250,938000,820750,703500,586250,410375,348819,226732,192722,134905,VEH_MANF_034,PRTL_14527,MFT2,13000
DELHI,SCANIA,MOT-PRD-003,G 500 XT 8X4 HEAVY,G 500 XT 8X4 HEAVY,PRTL_14521,12742,2,DIESEL,5464000,5190800,4644400,4371200,3824800,3278400,2732000,2458800,2185600,1912400,1639200,1366000,956200,812770,528301,449056,314339,VEH_MANF_141,PRTL_14521,MFT2,35000
PANAJI,ASHOK LEYLAND,MOT-PRD-003,ASHOK LEYLAND 3120,AL U 3120 BS VI,PRTL_14517,5660,2,DIESEL,3936000,3739200,3345600,3148800,2755200,2361600,1968000,1771200,1574400,1377600,1180800,984000,688800,585480,380562,323478,226435,VEH_MANF_023,PRTL_14517,MFT2,31000
PANAJI,FORCE MOTOR,MOT-PRD-005,TRAVELLER,TRAVELLER (C) (BSIV) SMOOTH,PRTL_14526,2596,21,DIESEL,1860000,1767000,1581000,1488000,1302000,1116000,930000,837000,744000,651000,558000,465000,325500,276675,179839,152863,107004,VEH_MANF_097,PRTL_14526,MFT2,0
PANAJI,TATA,MOT-PRD-003,TATA T.7 ULTRA ,TATA T.7 ULTRA DCR35CBC 100B6MS,PRTL_14515,2596,2,DIESEL,1595000,1515250,1355750,1276000,1116500,957000,797500,717750,638000,558250,478500,398750,279125,237256,154216,131084,91759,VEH_MANF_011,PRTL_14515,MFT2,7490
PANAJI,TATA,MOT-PRD-003,TATA T.7 ULTRA ,TATA T.18 ULTRA SLR56CBC BSVI,PRTL_14516,5055,2,DIESEL,1635000,1553250,1389750,1308000,1144500,981000,817500,735750,654000,572250,490500,408750,286125,243206,158084,134371,94060,VEH_MANF_011,PRTL_14516,MFT2,17600
PANAJI,EICHER,MOT-PRD-003,EICHER PRO 2110 XPT,PRO 2110XPT E FET PTO BSVI LY PRM,PRTL_14527,3760,3,DIESEL,2345000,2227750,1993250,1876000,1641500,1407000,1172500,1055250,938000,820750,703500,586250,410375,348819,226732,192722,134905,VEH_MANF_034,PRTL_14527,MFT2,13000
PANAJI,SCANIA,MOT-PRD-003,G 500 XT 8X4 HEAVY,G 500 XT 8X4 HEAVY,PRTL_14521,12742,2,DIESEL,5464000,5190800,4644400,4371200,3824800,3278400,2732000,2458800,2185600,1912400,1639200,1366000,956200,812770,528301,449056,314339,VEH_MANF_141,PRTL_14521,MFT2,35000
VADODARA,ASHOK LEYLAND,MOT-PRD-003,ASHOK LEYLAND 3120,AL U 3120 BS VI,PRTL_14517,5660,2,DIESEL,3936000,3739200,3345600,3148800,2755200,2361600,1968000,1771200,1574400,1377600,1180800,984000,688800,585480,380562,323478,226435,VEH_MANF_023,PRTL_14517,MFT2,31000
VADODARA,FORCE MOTOR,MOT-PRD-005,TRAVELLER,TRAVELLER (C) (BSIV) SMOOTH,PRTL_14526,2596,21,DIESEL,1860000,1767000,1581000,1488000,1302000,1116000,930000,837000,744000,651000,558000,465000,325500,276675,179839,152863,107004,VEH_MANF_097,PRTL_14526,MFT2,0
VADODARA,TATA,MOT-PRD-003,TATA T.7 ULTRA ,TATA T.7 ULTRA DCR35CBC 100B6MS,PRTL_14515,2596,2,DIESEL,1595000,1515250,1355750,1276000,1116500,957000,797500,717750,638000,558250,478500,398750,279125,237256,154216,131084,91759,VEH_MANF_011,PRTL_14515,MFT2,7490
VADODARA,TATA,MOT-PRD-003,TATA T.7 ULTRA ,TATA T.18 ULTRA SLR56CBC BSVI,PRTL_14516,5055,2,DIESEL,1635000,1553250,1389750,1308000,1144500,981000,817500,735750,654000,572250,490500,408750,286125,243206,158084,134371,94060,VEH_MANF_011,PRTL_14516,MFT2,17600
VADODARA,EICHER,MOT-PRD-003,EICHER PRO 2110 XPT,PRO 2110XPT E FET PTO BSVI LY PRM,PRTL_14527,3760,3,DIESEL,2345000,2227750,1993250,1876000,1641500,1407000,1172500,1055250,938000,820750,703500,586250,410375,348819,226732,192722,134905,VEH_MANF_034,PRTL_14527,MFT2,13000
VADODARA,SCANIA,MOT-PRD-003,G 500 XT 8X4 HEAVY,G 500 XT 8X4 HEAVY,PRTL_14521,12742,2,DIESEL,5464000,5190800,4644400,4371200,3824800,3278400,2732000,2458800,2185600,1912400,1639200,1366000,956200,812770,528301,449056,314339,VEH_MANF_141,PRTL_14521,MFT2,35000
FARIDABAD,ASHOK LEYLAND,MOT-PRD-003,ASHOK LEYLAND 3120,AL U 3120 BS VI,PRTL_14517,5660,2,DIESEL,3936000,3739200,3345600,3148800,2755200,2361600,1968000,1771200,1574400,1377600,1180800,984000,688800,585480,380562,323478,226435,VEH_MANF_023,PRTL_14517,MFT2,31000
FARIDABAD,FORCE MOTOR,MOT-PRD-005,TRAVELLER,TRAVELLER (C) (BSIV) SMOOTH,PRTL_14526,2596,21,DIESEL,1860000,1767000,1581000,1488000,1302000,1116000,930000,837000,744000,651000,558000,465000,325500,276675,179839,152863,107004,VEH_MANF_097,PRTL_14526,MFT2,0
FARIDABAD,TATA,MOT-PRD-003,TATA T.7 ULTRA ,TATA T.7 ULTRA DCR35CBC 100B6MS,PRTL_14515,2596,2,DIESEL,1595000,1515250,1355750,1276000,1116500,957000,797500,717750,638000,558250,478500,398750,279125,237256,154216,131084,91759,VEH_MANF_011,PRTL_14515,MFT2,7490
FARIDABAD,TATA,MOT-PRD-003,TATA T.7 ULTRA ,TATA T.18 ULTRA SLR56CBC BSVI,PRTL_14516,5055,2,DIESEL,1635000,1553250,1389750,1308000,1144500,981000,817500,735750,654000,572250,490500,408750,286125,243206,158084,134371,94060,VEH_MANF_011,PRTL_14516,MFT2,17600
FARIDABAD,EICHER,MOT-PRD-003,EICHER PRO 2110 XPT,PRO 2110XPT E FET PTO BSVI LY PRM,PRTL_14527,3760,3,DIESEL,2345000,2227750,1993250,1876000,1641500,1407000,1172500,1055250,938000,820750,703500,586250,410375,348819,226732,192722,134905,VEH_MANF_034,PRTL_14527,MFT2,13000
FARIDABAD,SCANIA,MOT-PRD-003,G 500 XT 8X4 HEAVY,G 500 XT 8X4 HEAVY,PRTL_14521,12742,2,DIESEL,5464000,5190800,4644400,4371200,3824800,3278400,2732000,2458800,2185600,1912400,1639200,1366000,956200,812770,528301,449056,314339,VEH_MANF_141,PRTL_14521,MFT2,35000
HIMACHAL PRA,ASHOK LEYLAND,MOT-PRD-003,ASHOK LEYLAND 3120,AL U 3120 BS VI,PRTL_14517,5660,2,DIESEL,3936000,3739200,3345600,3148800,2755200,2361600,1968000,1771200,1574400,1377600,1180800,984000,688800,585480,380562,323478,226435,VEH_MANF_023,PRTL_14517,MFT2,31000
HIMACHAL PRA,FORCE MOTOR,MOT-PRD-005,TRAVELLER,TRAVELLER (C) (BSIV) SMOOTH,PRTL_14526,2596,21,DIESEL,1860000,1767000,1581000,1488000,1302000,1116000,930000,837000,744000,651000,558000,465000,325500,276675,179839,152863,107004,VEH_MANF_097,PRTL_14526,MFT2,0
HIMACHAL PRA,TATA,MOT-PRD-003,TATA T.7 ULTRA ,TATA T.7 ULTRA DCR35CBC 100B6MS,PRTL_14515,2596,2,DIESEL,1595000,1515250,1355750,1276000,1116500,957000,797500,717750,638000,558250,478500,398750,279125,237256,154216,131084,91759,VEH_MANF_011,PRTL_14515,MFT2,7490
HIMACHAL PRA,TATA,MOT-PRD-003,TATA T.7 ULTRA ,TATA T.18 ULTRA SLR56CBC BSVI,PRTL_14516,5055,2,DIESEL,1635000,1553250,1389750,1308000,1144500,981000,817500,735750,654000,572250,490500,408750,286125,243206,158084,134371,94060,VEH_MANF_011,PRTL_14516,MFT2,17600
HIMACHAL PRA,EICHER,MOT-PRD-003,EICHER PRO 2110 XPT,PRO 2110XPT E FET PTO BSVI LY PRM,PRTL_14527,3760,3,DIESEL,2345000,2227750,1993250,1876000,1641500,1407000,1172500,1055250,938000,820750,703500,586250,410375,348819,226732,192722,134905,VEH_MANF_034,PRTL_14527,MFT2,13000
HIMACHAL PRA,SCANIA,MOT-PRD-003,G 500 XT 8X4 HEAVY,G 500 XT 8X4 HEAVY,PRTL_14521,12742,2,DIESEL,5464000,5190800,4644400,4371200,3824800,3278400,2732000,2458800,2185600,1912400,1639200,1366000,956200,812770,528301,449056,314339,VEH_MANF_141,PRTL_14521,MFT2,35000
JAMMU,ASHOK LEYLAND,MOT-PRD-003,ASHOK LEYLAND 3120,AL U 3120 BS VI,PRTL_14517,5660,2,DIESEL,3936000,3739200,3345600,3148800,2755200,2361600,1968000,1771200,1574400,1377600,1180800,984000,688800,585480,380562,323478,226435,VEH_MANF_023,PRTL_14517,MFT2,31000
JAMMU,FORCE MOTOR,MOT-PRD-005,TRAVELLER,TRAVELLER (C) (BSIV) SMOOTH,PRTL_14526,2596,21,DIESEL,1860000,1767000,1581000,1488000,1302000,1116000,930000,837000,744000,651000,558000,465000,325500,276675,179839,152863,107004,VEH_MANF_097,PRTL_14526,MFT2,0
JAMMU,TATA,MOT-PRD-003,TATA T.7 ULTRA ,TATA T.7 ULTRA DCR35CBC 100B6MS,PRTL_14515,2596,2,DIESEL,1595000,1515250,1355750,1276000,1116500,957000,797500,717750,638000,558250,478500,398750,279125,237256,154216,131084,91759,VEH_MANF_011,PRTL_14515,MFT2,7490
JAMMU,TATA,MOT-PRD-003,TATA T.7 ULTRA ,TATA T.18 ULTRA SLR56CBC BSVI,PRTL_14516,5055,2,DIESEL,1635000,1553250,1389750,1308000,1144500,981000,817500,735750,654000,572250,490500,408750,286125,243206,158084,134371,94060,VEH_MANF_011,PRTL_14516,MFT2,17600
JAMMU,EICHER,MOT-PRD-003,EICHER PRO 2110 XPT,PRO 2110XPT E FET PTO BSVI LY PRM,PRTL_14527,3760,3,DIESEL,2345000,2227750,1993250,1876000,1641500,1407000,1172500,1055250,938000,820750,703500,586250,410375,348819,226732,192722,134905,VEH_MANF_034,PRTL_14527,MFT2,13000
JAMMU,SCANIA,MOT-PRD-003,G 500 XT 8X4 HEAVY,G 500 XT 8X4 HEAVY,PRTL_14521,12742,2,DIESEL,5464000,5190800,4644400,4371200,3824800,3278400,2732000,2458800,2185600,1912400,1639200,1366000,956200,812770,528301,449056,314339,VEH_MANF_141,PRTL_14521,MFT2,35000
RANCHI,ASHOK LEYLAND,MOT-PRD-003,ASHOK LEYLAND 3120,AL U 3120 BS VI,PRTL_14517,5660,2,DIESEL,3936000,3739200,3345600,3148800,2755200,2361600,1968000,1771200,1574400,1377600,1180800,984000,688800,585480,380562,323478,226435,VEH_MANF_023,PRTL_14517,MFT2,31000
RANCHI,FORCE MOTOR,MOT-PRD-005,TRAVELLER,TRAVELLER (C) (BSIV) SMOOTH,PRTL_14526,2596,21,DIESEL,1860000,1767000,1581000,1488000,1302000,1116000,930000,837000,744000,651000,558000,465000,325500,276675,179839,152863,107004,VEH_MANF_097,PRTL_14526,MFT2,0
RANCHI,TATA,MOT-PRD-003,TATA T.7 ULTRA ,TATA T.7 ULTRA DCR35CBC 100B6MS,PRTL_14515,2596,2,DIESEL,1595000,1515250,1355750,1276000,1116500,957000,797500,717750,638000,558250,478500,398750,279125,237256,154216,131084,91759,VEH_MANF_011,PRTL_14515,MFT2,7490
RANCHI,TATA,MOT-PRD-003,TATA T.7 ULTRA ,TATA T.18 ULTRA SLR56CBC BSVI,PRTL_14516,5055,2,DIESEL,1635000,1553250,1389750,1308000,1144500,981000,817500,735750,654000,572250,490500,408750,286125,243206,158084,134371,94060,VEH_MANF_011,PRTL_14516,MFT2,17600
RANCHI,EICHER,MOT-PRD-003,EICHER PRO 2110 XPT,PRO 2110XPT E FET PTO BSVI LY PRM,PRTL_14527,3760,3,DIESEL,2345000,2227750,1993250,1876000,1641500,1407000,1172500,1055250,938000,820750,703500,586250,410375,348819,226732,192722,134905,VEH_MANF_034,PRTL_14527,MFT2,13000
RANCHI,SCANIA,MOT-PRD-003,G 500 XT 8X4 HEAVY,G 500 XT 8X4 HEAVY,PRTL_14521,12742,2,DIESEL,5464000,5190800,4644400,4371200,3824800,3278400,2732000,2458800,2185600,1912400,1639200,1366000,956200,812770,528301,449056,314339,VEH_MANF_141,PRTL_14521,MFT2,35000
BANGALORE,ASHOK LEYLAND,MOT-PRD-003,ASHOK LEYLAND 3120,AL U 3120 BS VI,PRTL_14517,5660,2,DIESEL,3936000,3739200,3345600,3148800,2755200,2361600,1968000,1771200,1574400,1377600,1180800,984000,688800,585480,380562,323478,226435,VEH_MANF_023,PRTL_14517,MFT2,31000
BANGALORE,FORCE MOTOR,MOT-PRD-005,TRAVELLER,TRAVELLER (C) (BSIV) SMOOTH,PRTL_14526,2596,21,DIESEL,1860000,1767000,1581000,1488000,1302000,1116000,930000,837000,744000,651000,558000,465000,325500,276675,179839,152863,107004,VEH_MANF_097,PRTL_14526,MFT2,0
BANGALORE,TATA,MOT-PRD-003,TATA T.7 ULTRA ,TATA T.7 ULTRA DCR35CBC 100B6MS,PRTL_14515,2596,2,DIESEL,1595000,1515250,1355750,1276000,1116500,957000,797500,717750,638000,558250,478500,398750,279125,237256,154216,131084,91759,VEH_MANF_011,PRTL_14515,MFT2,7490
BANGALORE,TATA,MOT-PRD-003,TATA T.7 ULTRA ,TATA T.18 ULTRA SLR56CBC BSVI,PRTL_14516,5055,2,DIESEL,1635000,1553250,1389750,1308000,1144500,981000,817500,735750,654000,572250,490500,408750,286125,243206,158084,134371,94060,VEH_MANF_011,PRTL_14516,MFT2,17600
BANGALORE,EICHER,MOT-PRD-003,EICHER PRO 2110 XPT,PRO 2110XPT E FET PTO BSVI LY PRM,PRTL_14527,3760,3,DIESEL,2345000,2227750,1993250,1876000,1641500,1407000,1172500,1055250,938000,820750,703500,586250,410375,348819,226732,192722,134905,VEH_MANF_034,PRTL_14527,MFT2,13000
BANGALORE,SCANIA,MOT-PRD-003,G 500 XT 8X4 HEAVY,G 500 XT 8X4 HEAVY,PRTL_14521,12742,2,DIESEL,5464000,5190800,4644400,4371200,3824800,3278400,2732000,2458800,2185600,1912400,1639200,1366000,956200,812770,528301,449056,314339,VEH_MANF_141,PRTL_14521,MFT2,35000
COCHIN,ASHOK LEYLAND,MOT-PRD-003,ASHOK LEYLAND 3120,AL U 3120 BS VI,PRTL_14517,5660,2,DIESEL,3936000,3739200,3345600,3148800,2755200,2361600,1968000,1771200,1574400,1377600,1180800,984000,688800,585480,380562,323478,226435,VEH_MANF_023,PRTL_14517,MFT2,31000
COCHIN,FORCE MOTOR,MOT-PRD-005,TRAVELLER,TRAVELLER (C) (BSIV) SMOOTH,PRTL_14526,2596,21,DIESEL,1860000,1767000,1581000,1488000,1302000,1116000,930000,837000,744000,651000,558000,465000,325500,276675,179839,152863,107004,VEH_MANF_097,PRTL_14526,MFT2,0
COCHIN,TATA,MOT-PRD-003,TATA T.7 ULTRA ,TATA T.7 ULTRA DCR35CBC 100B6MS,PRTL_14515,2596,2,DIESEL,1595000,1515250,1355750,1276000,1116500,957000,797500,717750,638000,558250,478500,398750,279125,237256,154216,131084,91759,VEH_MANF_011,PRTL_14515,MFT2,7490
COCHIN,TATA,MOT-PRD-003,TATA T.7 ULTRA ,TATA T.18 ULTRA SLR56CBC BSVI,PRTL_14516,5055,2,DIESEL,1635000,1553250,1389750,1308000,1144500,981000,817500,735750,654000,572250,490500,408750,286125,243206,158084,134371,94060,VEH_MANF_011,PRTL_14516,MFT2,17600
COCHIN,EICHER,MOT-PRD-003,EICHER PRO 2110 XPT,PRO 2110XPT E FET PTO BSVI LY PRM,PRTL_14527,3760,3,DIESEL,2345000,2227750,1993250,1876000,1641500,1407000,1172500,1055250,938000,820750,703500,586250,410375,348819,226732,192722,134905,VEH_MANF_034,PRTL_14527,MFT2,13000
COCHIN,SCANIA,MOT-PRD-003,G 500 XT 8X4 HEAVY,G 500 XT 8X4 HEAVY,PRTL_14521,12742,2,DIESEL,5464000,5190800,4644400,4371200,3824800,3278400,2732000,2458800,2185600,1912400,1639200,1366000,956200,812770,528301,449056,314339,VEH_MANF_141,PRTL_14521,MFT2,35000
INDORE,ASHOK LEYLAND,MOT-PRD-003,ASHOK LEYLAND 3120,AL U 3120 BS VI,PRTL_14517,5660,2,DIESEL,3936000,3739200,3345600,3148800,2755200,2361600,1968000,1771200,1574400,1377600,1180800,984000,688800,585480,380562,323478,226435,VEH_MANF_023,PRTL_14517,MFT2,31000
INDORE,FORCE MOTOR,MOT-PRD-005,TRAVELLER,TRAVELLER (C) (BSIV) SMOOTH,PRTL_14526,2596,21,DIESEL,1860000,1767000,1581000,1488000,1302000,1116000,930000,837000,744000,651000,558000,465000,325500,276675,179839,152863,107004,VEH_MANF_097,PRTL_14526,MFT2,0
INDORE,TATA,MOT-PRD-003,TATA T.7 ULTRA ,TATA T.7 ULTRA DCR35CBC 100B6MS,PRTL_14515,2596,2,DIESEL,1595000,1515250,1355750,1276000,1116500,957000,797500,717750,638000,558250,478500,398750,279125,237256,154216,131084,91759,VEH_MANF_011,PRTL_14515,MFT2,7490
INDORE,TATA,MOT-PRD-003,TATA T.7 ULTRA ,TATA T.18 ULTRA SLR56CBC BSVI,PRTL_14516,5055,2,DIESEL,1635000,1553250,1389750,1308000,1144500,981000,817500,735750,654000,572250,490500,408750,286125,243206,158084,134371,94060,VEH_MANF_011,PRTL_14516,MFT2,17600
INDORE,EICHER,MOT-PRD-003,EICHER PRO 2110 XPT,PRO 2110XPT E FET PTO BSVI LY PRM,PRTL_14527,3760,3,DIESEL,2345000,2227750,1993250,1876000,1641500,1407000,1172500,1055250,938000,820750,703500,586250,410375,348819,226732,192722,134905,VEH_MANF_034,PRTL_14527,MFT2,13000
INDORE,SCANIA,MOT-PRD-003,G 500 XT 8X4 HEAVY,G 500 XT 8X4 HEAVY,PRTL_14521,12742,2,DIESEL,5464000,5190800,4644400,4371200,3824800,3278400,2732000,2458800,2185600,1912400,1639200,1366000,956200,812770,528301,449056,314339,VEH_MANF_141,PRTL_14521,MFT2,35000
MUMBAI,ASHOK LEYLAND,MOT-PRD-003,ASHOK LEYLAND 3120,AL U 3120 BS VI,PRTL_14517,5660,2,DIESEL,3936000,3739200,3345600,3148800,2755200,2361600,1968000,1771200,1574400,1377600,1180800,984000,688800,585480,380562,323478,226435,VEH_MANF_023,PRTL_14517,MFT2,31000
MUMBAI,FORCE MOTOR,MOT-PRD-005,TRAVELLER,TRAVELLER (C) (BSIV) SMOOTH,PRTL_14526,2596,21,DIESEL,1860000,1767000,1581000,1488000,1302000,1116000,930000,837000,744000,651000,558000,465000,325500,276675,179839,152863,107004,VEH_MANF_097,PRTL_14526,MFT2,0
MUMBAI,TATA,MOT-PRD-003,TATA T.7 ULTRA ,TATA T.7 ULTRA DCR35CBC 100B6MS,PRTL_14515,2596,2,DIESEL,1595000,1515250,1355750,1276000,1116500,957000,797500,717750,638000,558250,478500,398750,279125,237256,154216,131084,91759,VEH_MANF_011,PRTL_14515,MFT2,7490
MUMBAI,TATA,MOT-PRD-003,TATA T.7 ULTRA ,TATA T.18 ULTRA SLR56CBC BSVI,PRTL_14516,5055,2,DIESEL,1635000,1553250,1389750,1308000,1144500,981000,817500,735750,654000,572250,490500,408750,286125,243206,158084,134371,94060,VEH_MANF_011,PRTL_14516,MFT2,17600
MUMBAI,EICHER,MOT-PRD-003,EICHER PRO 2110 XPT,PRO 2110XPT E FET PTO BSVI LY PRM,PRTL_14527,3760,3,DIESEL,2345000,2227750,1993250,1876000,1641500,1407000,1172500,1055250,938000,820750,703500,586250,410375,348819,226732,192722,134905,VEH_MANF_034,PRTL_14527,MFT2,13000
MUMBAI,SCANIA,MOT-PRD-003,G 500 XT 8X4 HEAVY,G 500 XT 8X4 HEAVY,PRTL_14521,12742,2,DIESEL,5464000,5190800,4644400,4371200,3824800,3278400,2732000,2458800,2185600,1912400,1639200,1366000,956200,812770,528301,449056,314339,VEH_MANF_141,PRTL_14521,MFT2,35000
IMPHAL,ASHOK LEYLAND,MOT-PRD-003,ASHOK LEYLAND 3120,AL U 3120 BS VI,PRTL_14517,5660,2,DIESEL,3936000,3739200,3345600,3148800,2755200,2361600,1968000,1771200,1574400,1377600,1180800,984000,688800,585480,380562,323478,226435,VEH_MANF_023,PRTL_14517,MFT2,31000
IMPHAL,FORCE MOTOR,MOT-PRD-005,TRAVELLER,TRAVELLER (C) (BSIV) SMOOTH,PRTL_14526,2596,21,DIESEL,1860000,1767000,1581000,1488000,1302000,1116000,930000,837000,744000,651000,558000,465000,325500,276675,179839,152863,107004,VEH_MANF_097,PRTL_14526,MFT2,0
IMPHAL,TATA,MOT-PRD-003,TATA T.7 ULTRA ,TATA T.7 ULTRA DCR35CBC 100B6MS,PRTL_14515,2596,2,DIESEL,1595000,1515250,1355750,1276000,1116500,957000,797500,717750,638000,558250,478500,398750,279125,237256,154216,131084,91759,VEH_MANF_011,PRTL_14515,MFT2,7490
IMPHAL,TATA,MOT-PRD-003,TATA T.7 ULTRA ,TATA T.18 ULTRA SLR56CBC BSVI,PRTL_14516,5055,2,DIESEL,1635000,1553250,1389750,1308000,1144500,981000,817500,735750,654000,572250,490500,408750,286125,243206,158084,134371,94060,VEH_MANF_011,PRTL_14516,MFT2,17600
IMPHAL,EICHER,MOT-PRD-003,EICHER PRO 2110 XPT,PRO 2110XPT E FET PTO BSVI LY PRM,PRTL_14527,3760,3,DIESEL,2345000,2227750,1993250,1876000,1641500,1407000,1172500,1055250,938000,820750,703500,586250,410375,348819,226732,192722,134905,VEH_MANF_034,PRTL_14527,MFT2,13000
IMPHAL,SCANIA,MOT-PRD-003,G 500 XT 8X4 HEAVY,G 500 XT 8X4 HEAVY,PRTL_14521,12742,2,DIESEL,5464000,5190800,4644400,4371200,3824800,3278400,2732000,2458800,2185600,1912400,1639200,1366000,956200,812770,528301,449056,314339,VEH_MANF_141,PRTL_14521,MFT2,35000
SHILLONG,ASHOK LEYLAND,MOT-PRD-003,ASHOK LEYLAND 3120,AL U 3120 BS VI,PRTL_14517,5660,2,DIESEL,3936000,3739200,3345600,3148800,2755200,2361600,1968000,1771200,1574400,1377600,1180800,984000,688800,585480,380562,323478,226435,VEH_MANF_023,PRTL_14517,MFT2,31000
SHILLONG,FORCE MOTOR,MOT-PRD-005,TRAVELLER,TRAVELLER (C) (BSIV) SMOOTH,PRTL_14526,2596,21,DIESEL,1860000,1767000,1581000,1488000,1302000,1116000,930000,837000,744000,651000,558000,465000,325500,276675,179839,152863,107004,VEH_MANF_097,PRTL_14526,MFT2,0
SHILLONG,TATA,MOT-PRD-003,TATA T.7 ULTRA ,TATA T.7 ULTRA DCR35CBC 100B6MS,PRTL_14515,2596,2,DIESEL,1595000,1515250,1355750,1276000,1116500,957000,797500,717750,638000,558250,478500,398750,279125,237256,154216,131084,91759,VEH_MANF_011,PRTL_14515,MFT2,7490
SHILLONG,TATA,MOT-PRD-003,TATA T.7 ULTRA ,TATA T.18 ULTRA SLR56CBC BSVI,PRTL_14516,5055,2,DIESEL,1635000,1553250,1389750,1308000,1144500,981000,817500,735750,654000,572250,490500,408750,286125,243206,158084,134371,94060,VEH_MANF_011,PRTL_14516,MFT2,17600
SHILLONG,EICHER,MOT-PRD-003,EICHER PRO 2110 XPT,PRO 2110XPT E FET PTO BSVI LY PRM,PRTL_14527,3760,3,DIESEL,2345000,2227750,1993250,1876000,1641500,1407000,1172500,1055250,938000,820750,703500,586250,410375,348819,226732,192722,134905,VEH_MANF_034,PRTL_14527,MFT2,13000
SHILLONG,SCANIA,MOT-PRD-003,G 500 XT 8X4 HEAVY,G 500 XT 8X4 HEAVY,PRTL_14521,12742,2,DIESEL,5464000,5190800,4644400,4371200,3824800,3278400,2732000,2458800,2185600,1912400,1639200,1366000,956200,812770,528301,449056,314339,VEH_MANF_141,PRTL_14521,MFT2,35000
AIZAWL,ASHOK LEYLAND,MOT-PRD-003,ASHOK LEYLAND 3120,AL U 3120 BS VI,PRTL_14517,5660,2,DIESEL,3936000,3739200,3345600,3148800,2755200,2361600,1968000,1771200,1574400,1377600,1180800,984000,688800,585480,380562,323478,226435,VEH_MANF_023,PRTL_14517,MFT2,31000
AIZAWL,FORCE MOTOR,MOT-PRD-005,TRAVELLER,TRAVELLER (C) (BSIV) SMOOTH,PRTL_14526,2596,21,DIESEL,1860000,1767000,1581000,1488000,1302000,1116000,930000,837000,744000,651000,558000,465000,325500,276675,179839,152863,107004,VEH_MANF_097,PRTL_14526,MFT2,0
AIZAWL,TATA,MOT-PRD-003,TATA T.7 ULTRA ,TATA T.7 ULTRA DCR35CBC 100B6MS,PRTL_14515,2596,2,DIESEL,1595000,1515250,1355750,1276000,1116500,957000,797500,717750,638000,558250,478500,398750,279125,237256,154216,131084,91759,VEH_MANF_011,PRTL_14515,MFT2,7490
AIZAWL,TATA,MOT-PRD-003,TATA T.7 ULTRA ,TATA T.18 ULTRA SLR56CBC BSVI,PRTL_14516,5055,2,DIESEL,1635000,1553250,1389750,1308000,1144500,981000,817500,735750,654000,572250,490500,408750,286125,243206,158084,134371,94060,VEH_MANF_011,PRTL_14516,MFT2,17600
AIZAWL,EICHER,MOT-PRD-003,EICHER PRO 2110 XPT,PRO 2110XPT E FET PTO BSVI LY PRM,PRTL_14527,3760,3,DIESEL,2345000,2227750,1993250,1876000,1641500,1407000,1172500,1055250,938000,820750,703500,586250,410375,348819,226732,192722,134905,VEH_MANF_034,PRTL_14527,MFT2,13000
AIZAWL,SCANIA,MOT-PRD-003,G 500 XT 8X4 HEAVY,G 500 XT 8X4 HEAVY,PRTL_14521,12742,2,DIESEL,5464000,5190800,4644400,4371200,3824800,3278400,2732000,2458800,2185600,1912400,1639200,1366000,956200,812770,528301,449056,314339,VEH_MANF_141,PRTL_14521,MFT2,35000
KOHIMA,ASHOK LEYLAND,MOT-PRD-003,ASHOK LEYLAND 3120,AL U 3120 BS VI,PRTL_14517,5660,2,DIESEL,3936000,3739200,3345600,3148800,2755200,2361600,1968000,1771200,1574400,1377600,1180800,984000,688800,585480,380562,323478,226435,VEH_MANF_023,PRTL_14517,MFT2,31000
KOHIMA,FORCE MOTOR,MOT-PRD-005,TRAVELLER,TRAVELLER (C) (BSIV) SMOOTH,PRTL_14526,2596,21,DIESEL,1860000,1767000,1581000,1488000,1302000,1116000,930000,837000,744000,651000,558000,465000,325500,276675,179839,152863,107004,VEH_MANF_097,PRTL_14526,MFT2,0
KOHIMA,TATA,MOT-PRD-003,TATA T.7 ULTRA ,TATA T.7 ULTRA DCR35CBC 100B6MS,PRTL_14515,2596,2,DIESEL,1595000,1515250,1355750,1276000,1116500,957000,797500,717750,638000,558250,478500,398750,279125,237256,154216,131084,91759,VEH_MANF_011,PRTL_14515,MFT2,7490
KOHIMA,TATA,MOT-PRD-003,TATA T.7 ULTRA ,TATA T.18 ULTRA SLR56CBC BSVI,PRTL_14516,5055,2,DIESEL,1635000,1553250,1389750,1308000,1144500,981000,817500,735750,654000,572250,490500,408750,286125,243206,158084,134371,94060,VEH_MANF_011,PRTL_14516,MFT2,17600
KOHIMA,EICHER,MOT-PRD-003,EICHER PRO 2110 XPT,PRO 2110XPT E FET PTO BSVI LY PRM,PRTL_14527,3760,3,DIESEL,2345000,2227750,1993250,1876000,1641500,1407000,1172500,1055250,938000,820750,703500,586250,410375,348819,226732,192722,134905,VEH_MANF_034,PRTL_14527,MFT2,13000
KOHIMA,SCANIA,MOT-PRD-003,G 500 XT 8X4 HEAVY,G 500 XT 8X4 HEAVY,PRTL_14521,12742,2,DIESEL,5464000,5190800,4644400,4371200,3824800,3278400,2732000,2458800,2185600,1912400,1639200,1366000,956200,812770,528301,449056,314339,VEH_MANF_141,PRTL_14521,MFT2,35000
BHUBANESHWAR,ASHOK LEYLAND,MOT-PRD-003,ASHOK LEYLAND 3120,AL U 3120 BS VI,PRTL_14517,5660,2,DIESEL,3936000,3739200,3345600,3148800,2755200,2361600,1968000,1771200,1574400,1377600,1180800,984000,688800,585480,380562,323478,226435,VEH_MANF_023,PRTL_14517,MFT2,31000
BHUBANESHWAR,FORCE MOTOR,MOT-PRD-005,TRAVELLER,TRAVELLER (C) (BSIV) SMOOTH,PRTL_14526,2596,21,DIESEL,1860000,1767000,1581000,1488000,1302000,1116000,930000,837000,744000,651000,558000,465000,325500,276675,179839,152863,107004,VEH_MANF_097,PRTL_14526,MFT2,0
BHUBANESHWAR,TATA,MOT-PRD-003,TATA T.7 ULTRA ,TATA T.7 ULTRA DCR35CBC 100B6MS,PRTL_14515,2596,2,DIESEL,1595000,1515250,1355750,1276000,1116500,957000,797500,717750,638000,558250,478500,398750,279125,237256,154216,131084,91759,VEH_MANF_011,PRTL_14515,MFT2,7490
BHUBANESHWAR,TATA,MOT-PRD-003,TATA T.7 ULTRA ,TATA T.18 ULTRA SLR56CBC BSVI,PRTL_14516,5055,2,DIESEL,1635000,1553250,1389750,1308000,1144500,981000,817500,735750,654000,572250,490500,408750,286125,243206,158084,134371,94060,VEH_MANF_011,PRTL_14516,MFT2,17600
BHUBANESHWAR,EICHER,MOT-PRD-003,EICHER PRO 2110 XPT,PRO 2110XPT E FET PTO BSVI LY PRM,PRTL_14527,3760,3,DIESEL,2345000,2227750,1993250,1876000,1641500,1407000,1172500,1055250,938000,820750,703500,586250,410375,348819,226732,192722,134905,VEH_MANF_034,PRTL_14527,MFT2,13000
BHUBANESHWAR,SCANIA,MOT-PRD-003,G 500 XT 8X4 HEAVY,G 500 XT 8X4 HEAVY,PRTL_14521,12742,2,DIESEL,5464000,5190800,4644400,4371200,3824800,3278400,2732000,2458800,2185600,1912400,1639200,1366000,956200,812770,528301,449056,314339,VEH_MANF_141,PRTL_14521,MFT2,35000
PONDICHERRY,ASHOK LEYLAND,MOT-PRD-003,ASHOK LEYLAND 3120,AL U 3120 BS VI,PRTL_14517,5660,2,DIESEL,3936000,3739200,3345600,3148800,2755200,2361600,1968000,1771200,1574400,1377600,1180800,984000,688800,585480,380562,323478,226435,VEH_MANF_023,PRTL_14517,MFT2,31000
PONDICHERRY,FORCE MOTOR,MOT-PRD-005,TRAVELLER,TRAVELLER (C) (BSIV) SMOOTH,PRTL_14526,2596,21,DIESEL,1860000,1767000,1581000,1488000,1302000,1116000,930000,837000,744000,651000,558000,465000,325500,276675,179839,152863,107004,VEH_MANF_097,PRTL_14526,MFT2,0
PONDICHERRY,TATA,MOT-PRD-003,TATA T.7 ULTRA ,TATA T.7 ULTRA DCR35CBC 100B6MS,PRTL_14515,2596,2,DIESEL,1595000,1515250,1355750,1276000,1116500,957000,797500,717750,638000,558250,478500,398750,279125,237256,154216,131084,91759,VEH_MANF_011,PRTL_14515,MFT2,7490
PONDICHERRY,TATA,MOT-PRD-003,TATA T.7 ULTRA ,TATA T.18 ULTRA SLR56CBC BSVI,PRTL_14516,5055,2,DIESEL,1635000,1553250,1389750,1308000,1144500,981000,817500,735750,654000,572250,490500,408750,286125,243206,158084,134371,94060,VEH_MANF_011,PRTL_14516,MFT2,17600
PONDICHERRY,EICHER,MOT-PRD-003,EICHER PRO 2110 XPT,PRO 2110XPT E FET PTO BSVI LY PRM,PRTL_14527,3760,3,DIESEL,2345000,2227750,1993250,1876000,1641500,1407000,1172500,1055250,938000,820750,703500,586250,410375,348819,226732,192722,134905,VEH_MANF_034,PRTL_14527,MFT2,13000
PONDICHERRY,SCANIA,MOT-PRD-003,G 500 XT 8X4 HEAVY,G 500 XT 8X4 HEAVY,PRTL_14521,12742,2,DIESEL,5464000,5190800,4644400,4371200,3824800,3278400,2732000,2458800,2185600,1912400,1639200,1366000,956200,812770,528301,449056,314339,VEH_MANF_141,PRTL_14521,MFT2,35000
LUDHIANA,ASHOK LEYLAND,MOT-PRD-003,ASHOK LEYLAND 3120,AL U 3120 BS VI,PRTL_14517,5660,2,DIESEL,3936000,3739200,3345600,3148800,2755200,2361600,1968000,1771200,1574400,1377600,1180800,984000,688800,585480,380562,323478,226435,VEH_MANF_023,PRTL_14517,MFT2,31000
LUDHIANA,FORCE MOTOR,MOT-PRD-005,TRAVELLER,TRAVELLER (C) (BSIV) SMOOTH,PRTL_14526,2596,21,DIESEL,1860000,1767000,1581000,1488000,1302000,1116000,930000,837000,744000,651000,558000,465000,325500,276675,179839,152863,107004,VEH_MANF_097,PRTL_14526,MFT2,0
LUDHIANA,TATA,MOT-PRD-003,TATA T.7 ULTRA ,TATA T.7 ULTRA DCR35CBC 100B6MS,PRTL_14515,2596,2,DIESEL,1595000,1515250,1355750,1276000,1116500,957000,797500,717750,638000,558250,478500,398750,279125,237256,154216,131084,91759,VEH_MANF_011,PRTL_14515,MFT2,7490
LUDHIANA,TATA,MOT-PRD-003,TATA T.7 ULTRA ,TATA T.18 ULTRA SLR56CBC BSVI,PRTL_14516,5055,2,DIESEL,1635000,1553250,1389750,1308000,1144500,981000,817500,735750,654000,572250,490500,408750,286125,243206,158084,134371,94060,VEH_MANF_011,PRTL_14516,MFT2,17600
LUDHIANA,EICHER,MOT-PRD-003,EICHER PRO 2110 XPT,PRO 2110XPT E FET PTO BSVI LY PRM,PRTL_14527,3760,3,DIESEL,2345000,2227750,1993250,1876000,1641500,1407000,1172500,1055250,938000,820750,703500,586250,410375,348819,226732,192722,134905,VEH_MANF_034,PRTL_14527,MFT2,13000
LUDHIANA,SCANIA,MOT-PRD-003,G 500 XT 8X4 HEAVY,G 500 XT 8X4 HEAVY,PRTL_14521,12742,2,DIESEL,5464000,5190800,4644400,4371200,3824800,3278400,2732000,2458800,2185600,1912400,1639200,1366000,956200,812770,528301,449056,314339,VEH_MANF_141,PRTL_14521,MFT2,35000
JAIPUR,ASHOK LEYLAND,MOT-PRD-003,ASHOK LEYLAND 3120,AL U 3120 BS VI,PRTL_14517,5660,2,DIESEL,3936000,3739200,3345600,3148800,2755200,2361600,1968000,1771200,1574400,1377600,1180800,984000,688800,585480,380562,323478,226435,VEH_MANF_023,PRTL_14517,MFT2,31000
JAIPUR,FORCE MOTOR,MOT-PRD-005,TRAVELLER,TRAVELLER (C) (BSIV) SMOOTH,PRTL_14526,2596,21,DIESEL,1860000,1767000,1581000,1488000,1302000,1116000,930000,837000,744000,651000,558000,465000,325500,276675,179839,152863,107004,VEH_MANF_097,PRTL_14526,MFT2,0
JAIPUR,TATA,MOT-PRD-003,TATA T.7 ULTRA ,TATA T.7 ULTRA DCR35CBC 100B6MS,PRTL_14515,2596,2,DIESEL,1595000,1515250,1355750,1276000,1116500,957000,797500,717750,638000,558250,478500,398750,279125,237256,154216,131084,91759,VEH_MANF_011,PRTL_14515,MFT2,7490
JAIPUR,TATA,MOT-PRD-003,TATA T.7 ULTRA ,TATA T.18 ULTRA SLR56CBC BSVI,PRTL_14516,5055,2,DIESEL,1635000,1553250,1389750,1308000,1144500,981000,817500,735750,654000,572250,490500,408750,286125,243206,158084,134371,94060,VEH_MANF_011,PRTL_14516,MFT2,17600
JAIPUR,EICHER,MOT-PRD-003,EICHER PRO 2110 XPT,PRO 2110XPT E FET PTO BSVI LY PRM,PRTL_14527,3760,3,DIESEL,2345000,2227750,1993250,1876000,1641500,1407000,1172500,1055250,938000,820750,703500,586250,410375,348819,226732,192722,134905,VEH_MANF_034,PRTL_14527,MFT2,13000
JAIPUR,SCANIA,MOT-PRD-003,G 500 XT 8X4 HEAVY,G 500 XT 8X4 HEAVY,PRTL_14521,12742,2,DIESEL,5464000,5190800,4644400,4371200,3824800,3278400,2732000,2458800,2185600,1912400,1639200,1366000,956200,812770,528301,449056,314339,VEH_MANF_141,PRTL_14521,MFT2,35000
GANGTOK,ASHOK LEYLAND,MOT-PRD-003,ASHOK LEYLAND 3120,AL U 3120 BS VI,PRTL_14517,5660,2,DIESEL,3936000,3739200,3345600,3148800,2755200,2361600,1968000,1771200,1574400,1377600,1180800,984000,688800,585480,380562,323478,226435,VEH_MANF_023,PRTL_14517,MFT2,31000
GANGTOK,FORCE MOTOR,MOT-PRD-005,TRAVELLER,TRAVELLER (C) (BSIV) SMOOTH,PRTL_14526,2596,21,DIESEL,1860000,1767000,1581000,1488000,1302000,1116000,930000,837000,744000,651000,558000,465000,325500,276675,179839,152863,107004,VEH_MANF_097,PRTL_14526,MFT2,0
GANGTOK,TATA,MOT-PRD-003,TATA T.7 ULTRA ,TATA T.7 ULTRA DCR35CBC 100B6MS,PRTL_14515,2596,2,DIESEL,1595000,1515250,1355750,1276000,1116500,957000,797500,717750,638000,558250,478500,398750,279125,237256,154216,131084,91759,VEH_MANF_011,PRTL_14515,MFT2,7490
GANGTOK,TATA,MOT-PRD-003,TATA T.7 ULTRA ,TATA T.18 ULTRA SLR56CBC BSVI,PRTL_14516,5055,2,DIESEL,1635000,1553250,1389750,1308000,1144500,981000,817500,735750,654000,572250,490500,408750,286125,243206,158084,134371,94060,VEH_MANF_011,PRTL_14516,MFT2,17600
GANGTOK,EICHER,MOT-PRD-003,EICHER PRO 2110 XPT,PRO 2110XPT E FET PTO BSVI LY PRM,PRTL_14527,3760,3,DIESEL,2345000,2227750,1993250,1876000,1641500,1407000,1172500,1055250,938000,820750,703500,586250,410375,348819,226732,192722,134905,VEH_MANF_034,PRTL_14527,MFT2,13000
GANGTOK,SCANIA,MOT-PRD-003,G 500 XT 8X4 HEAVY,G 500 XT 8X4 HEAVY,PRTL_14521,12742,2,DIESEL,5464000,5190800,4644400,4371200,3824800,3278400,2732000,2458800,2185600,1912400,1639200,1366000,956200,812770,528301,449056,314339,VEH_MANF_141,PRTL_14521,MFT2,35000
COIMBATORE,ASHOK LEYLAND,MOT-PRD-003,ASHOK LEYLAND 3120,AL U 3120 BS VI,PRTL_14517,5660,2,DIESEL,3936000,3739200,3345600,3148800,2755200,2361600,1968000,1771200,1574400,1377600,1180800,984000,688800,585480,380562,323478,226435,VEH_MANF_023,PRTL_14517,MFT2,31000
COIMBATORE,FORCE MOTOR,MOT-PRD-005,TRAVELLER,TRAVELLER (C) (BSIV) SMOOTH,PRTL_14526,2596,21,DIESEL,1860000,1767000,1581000,1488000,1302000,1116000,930000,837000,744000,651000,558000,465000,325500,276675,179839,152863,107004,VEH_MANF_097,PRTL_14526,MFT2,0
COIMBATORE,TATA,MOT-PRD-003,TATA T.7 ULTRA ,TATA T.7 ULTRA DCR35CBC 100B6MS,PRTL_14515,2596,2,DIESEL,1595000,1515250,1355750,1276000,1116500,957000,797500,717750,638000,558250,478500,398750,279125,237256,154216,131084,91759,VEH_MANF_011,PRTL_14515,MFT2,7490
COIMBATORE,TATA,MOT-PRD-003,TATA T.7 ULTRA ,TATA T.18 ULTRA SLR56CBC BSVI,PRTL_14516,5055,2,DIESEL,1635000,1553250,1389750,1308000,1144500,981000,817500,735750,654000,572250,490500,408750,286125,243206,158084,134371,94060,VEH_MANF_011,PRTL_14516,MFT2,17600
COIMBATORE,EICHER,MOT-PRD-003,EICHER PRO 2110 XPT,PRO 2110XPT E FET PTO BSVI LY PRM,PRTL_14527,3760,3,DIESEL,2345000,2227750,1993250,1876000,1641500,1407000,1172500,1055250,938000,820750,703500,586250,410375,348819,226732,192722,134905,VEH_MANF_034,PRTL_14527,MFT2,13000
COIMBATORE,SCANIA,MOT-PRD-003,G 500 XT 8X4 HEAVY,G 500 XT 8X4 HEAVY,PRTL_14521,12742,2,DIESEL,5464000,5190800,4644400,4371200,3824800,3278400,2732000,2458800,2185600,1912400,1639200,1366000,956200,812770,528301,449056,314339,VEH_MANF_141,PRTL_14521,MFT2,35000
HYDERABAD,ASHOK LEYLAND,MOT-PRD-003,ASHOK LEYLAND 3120,AL U 3120 BS VI,PRTL_14517,5660,2,DIESEL,3936000,3739200,3345600,3148800,2755200,2361600,1968000,1771200,1574400,1377600,1180800,984000,688800,585480,380562,323478,226435,VEH_MANF_023,PRTL_14517,MFT2,31000
HYDERABAD,FORCE MOTOR,MOT-PRD-005,TRAVELLER,TRAVELLER (C) (BSIV) SMOOTH,PRTL_14526,2596,21,DIESEL,1860000,1767000,1581000,1488000,1302000,1116000,930000,837000,744000,651000,558000,465000,325500,276675,179839,152863,107004,VEH_MANF_097,PRTL_14526,MFT2,0
HYDERABAD,TATA,MOT-PRD-003,TATA T.7 ULTRA ,TATA T.7 ULTRA DCR35CBC 100B6MS,PRTL_14515,2596,2,DIESEL,1595000,1515250,1355750,1276000,1116500,957000,797500,717750,638000,558250,478500,398750,279125,237256,154216,131084,91759,VEH_MANF_011,PRTL_14515,MFT2,7490
HYDERABAD,TATA,MOT-PRD-003,TATA T.7 ULTRA ,TATA T.18 ULTRA SLR56CBC BSVI,PRTL_14516,5055,2,DIESEL,1635000,1553250,1389750,1308000,1144500,981000,817500,735750,654000,572250,490500,408750,286125,243206,158084,134371,94060,VEH_MANF_011,PRTL_14516,MFT2,17600
HYDERABAD,EICHER,MOT-PRD-003,EICHER PRO 2110 XPT,PRO 2110XPT E FET PTO BSVI LY PRM,PRTL_14527,3760,3,DIESEL,2345000,2227750,1993250,1876000,1641500,1407000,1172500,1055250,938000,820750,703500,586250,410375,348819,226732,192722,134905,VEH_MANF_034,PRTL_14527,MFT2,13000
HYDERABAD,SCANIA,MOT-PRD-003,G 500 XT 8X4 HEAVY,G 500 XT 8X4 HEAVY,PRTL_14521,12742,2,DIESEL,5464000,5190800,4644400,4371200,3824800,3278400,2732000,2458800,2185600,1912400,1639200,1366000,956200,812770,528301,449056,314339,VEH_MANF_141,PRTL_14521,MFT2,35000
AGARTALA,ASHOK LEYLAND,MOT-PRD-003,ASHOK LEYLAND 3120,AL U 3120 BS VI,PRTL_14517,5660,2,DIESEL,3936000,3739200,3345600,3148800,2755200,2361600,1968000,1771200,1574400,1377600,1180800,984000,688800,585480,380562,323478,226435,VEH_MANF_023,PRTL_14517,MFT2,31000
AGARTALA,FORCE MOTOR,MOT-PRD-005,TRAVELLER,TRAVELLER (C) (BSIV) SMOOTH,PRTL_14526,2596,21,DIESEL,1860000,1767000,1581000,1488000,1302000,1116000,930000,837000,744000,651000,558000,465000,325500,276675,179839,152863,107004,VEH_MANF_097,PRTL_14526,MFT2,0
AGARTALA,TATA,MOT-PRD-003,TATA T.7 ULTRA ,TATA T.7 ULTRA DCR35CBC 100B6MS,PRTL_14515,2596,2,DIESEL,1595000,1515250,1355750,1276000,1116500,957000,797500,717750,638000,558250,478500,398750,279125,237256,154216,131084,91759,VEH_MANF_011,PRTL_14515,MFT2,7490
AGARTALA,TATA,MOT-PRD-003,TATA T.7 ULTRA ,TATA T.18 ULTRA SLR56CBC BSVI,PRTL_14516,5055,2,DIESEL,1635000,1553250,1389750,1308000,1144500,981000,817500,735750,654000,572250,490500,408750,286125,243206,158084,134371,94060,VEH_MANF_011,PRTL_14516,MFT2,17600
AGARTALA,EICHER,MOT-PRD-003,EICHER PRO 2110 XPT,PRO 2110XPT E FET PTO BSVI LY PRM,PRTL_14527,3760,3,DIESEL,2345000,2227750,1993250,1876000,1641500,1407000,1172500,1055250,938000,820750,703500,586250,410375,348819,226732,192722,134905,VEH_MANF_034,PRTL_14527,MFT2,13000
AGARTALA,SCANIA,MOT-PRD-003,G 500 XT 8X4 HEAVY,G 500 XT 8X4 HEAVY,PRTL_14521,12742,2,DIESEL,5464000,5190800,4644400,4371200,3824800,3278400,2732000,2458800,2185600,1912400,1639200,1366000,956200,812770,528301,449056,314339,VEH_MANF_141,PRTL_14521,MFT2,35000
LUCKNOW,ASHOK LEYLAND,MOT-PRD-003,ASHOK LEYLAND 3120,AL U 3120 BS VI,PRTL_14517,5660,2,DIESEL,3936000,3739200,3345600,3148800,2755200,2361600,1968000,1771200,1574400,1377600,1180800,984000,688800,585480,380562,323478,226435,VEH_MANF_023,PRTL_14517,MFT2,31000
LUCKNOW,FORCE MOTOR,MOT-PRD-005,TRAVELLER,TRAVELLER (C) (BSIV) SMOOTH,PRTL_14526,2596,21,DIESEL,1860000,1767000,1581000,1488000,1302000,1116000,930000,837000,744000,651000,558000,465000,325500,276675,179839,152863,107004,VEH_MANF_097,PRTL_14526,MFT2,0
LUCKNOW,TATA,MOT-PRD-003,TATA T.7 ULTRA ,TATA T.7 ULTRA DCR35CBC 100B6MS,PRTL_14515,2596,2,DIESEL,1595000,1515250,1355750,1276000,1116500,957000,797500,717750,638000,558250,478500,398750,279125,237256,154216,131084,91759,VEH_MANF_011,PRTL_14515,MFT2,7490
LUCKNOW,TATA,MOT-PRD-003,TATA T.7 ULTRA ,TATA T.18 ULTRA SLR56CBC BSVI,PRTL_14516,5055,2,DIESEL,1635000,1553250,1389750,1308000,1144500,981000,817500,735750,654000,572250,490500,408750,286125,243206,158084,134371,94060,VEH_MANF_011,PRTL_14516,MFT2,17600
LUCKNOW,EICHER,MOT-PRD-003,EICHER PRO 2110 XPT,PRO 2110XPT E FET PTO BSVI LY PRM,PRTL_14527,3760,3,DIESEL,2345000,2227750,1993250,1876000,1641500,1407000,1172500,1055250,938000,820750,703500,586250,410375,348819,226732,192722,134905,VEH_MANF_034,PRTL_14527,MFT2,13000
LUCKNOW,SCANIA,MOT-PRD-003,G 500 XT 8X4 HEAVY,G 500 XT 8X4 HEAVY,PRTL_14521,12742,2,DIESEL,5464000,5190800,4644400,4371200,3824800,3278400,2732000,2458800,2185600,1912400,1639200,1366000,956200,812770,528301,449056,314339,VEH_MANF_141,PRTL_14521,MFT2,35000
DEHRADUN,ASHOK LEYLAND,MOT-PRD-003,ASHOK LEYLAND 3120,AL U 3120 BS VI,PRTL_14517,5660,2,DIESEL,3936000,3739200,3345600,3148800,2755200,2361600,1968000,1771200,1574400,1377600,1180800,984000,688800,585480,380562,323478,226435,VEH_MANF_023,PRTL_14517,MFT2,31000
DEHRADUN,FORCE MOTOR,MOT-PRD-005,TRAVELLER,TRAVELLER (C) (BSIV) SMOOTH,PRTL_14526,2596,21,DIESEL,1860000,1767000,1581000,1488000,1302000,1116000,930000,837000,744000,651000,558000,465000,325500,276675,179839,152863,107004,VEH_MANF_097,PRTL_14526,MFT2,0
DEHRADUN,TATA,MOT-PRD-003,TATA T.7 ULTRA ,TATA T.7 ULTRA DCR35CBC 100B6MS,PRTL_14515,2596,2,DIESEL,1595000,1515250,1355750,1276000,1116500,957000,797500,717750,638000,558250,478500,398750,279125,237256,154216,131084,91759,VEH_MANF_011,PRTL_14515,MFT2,7490
DEHRADUN,TATA,MOT-PRD-003,TATA T.7 ULTRA ,TATA T.18 ULTRA SLR56CBC BSVI,PRTL_14516,5055,2,DIESEL,1635000,1553250,1389750,1308000,1144500,981000,817500,735750,654000,572250,490500,408750,286125,243206,158084,134371,94060,VEH_MANF_011,PRTL_14516,MFT2,17600
DEHRADUN,EICHER,MOT-PRD-003,EICHER PRO 2110 XPT,PRO 2110XPT E FET PTO BSVI LY PRM,PRTL_14527,3760,3,DIESEL,2345000,2227750,1993250,1876000,1641500,1407000,1172500,1055250,938000,820750,703500,586250,410375,348819,226732,192722,134905,VEH_MANF_034,PRTL_14527,MFT2,13000
DEHRADUN,SCANIA,MOT-PRD-003,G 500 XT 8X4 HEAVY,G 500 XT 8X4 HEAVY,PRTL_14521,12742,2,DIESEL,5464000,5190800,4644400,4371200,3824800,3278400,2732000,2458800,2185600,1912400,1639200,1366000,956200,812770,528301,449056,314339,VEH_MANF_141,PRTL_14521,MFT2,35000
KOLKATA,ASHOK LEYLAND,MOT-PRD-003,ASHOK LEYLAND 3120,AL U 3120 BS VI,PRTL_14517,5660,2,DIESEL,3936000,3739200,3345600,3148800,2755200,2361600,1968000,1771200,1574400,1377600,1180800,984000,688800,585480,380562,323478,226435,VEH_MANF_023,PRTL_14517,MFT2,31000
KOLKATA,FORCE MOTOR,MOT-PRD-005,TRAVELLER,TRAVELLER (C) (BSIV) SMOOTH,PRTL_14526,2596,21,DIESEL,1860000,1767000,1581000,1488000,1302000,1116000,930000,837000,744000,651000,558000,465000,325500,276675,179839,152863,107004,VEH_MANF_097,PRTL_14526,MFT2,0
KOLKATA,TATA,MOT-PRD-003,TATA T.7 ULTRA ,TATA T.7 ULTRA DCR35CBC 100B6MS,PRTL_14515,2596,2,DIESEL,1595000,1515250,1355750,1276000,1116500,957000,797500,717750,638000,558250,478500,398750,279125,237256,154216,131084,91759,VEH_MANF_011,PRTL_14515,MFT2,7490
KOLKATA,TATA,MOT-PRD-003,TATA T.7 ULTRA ,TATA T.18 ULTRA SLR56CBC BSVI,PRTL_14516,5055,2,DIESEL,1635000,1553250,1389750,1308000,1144500,981000,817500,735750,654000,572250,490500,408750,286125,243206,158084,134371,94060,VEH_MANF_011,PRTL_14516,MFT2,17600
KOLKATA,EICHER,MOT-PRD-003,EICHER PRO 2110 XPT,PRO 2110XPT E FET PTO BSVI LY PRM,PRTL_14527,3760,3,DIESEL,2345000,2227750,1993250,1876000,1641500,1407000,1172500,1055250,938000,820750,703500,586250,410375,348819,226732,192722,134905,VEH_MANF_034,PRTL_14527,MFT2,13000
KOLKATA,SCANIA,MOT-PRD-003,G 500 XT 8X4 HEAVY,G 500 XT 8X4 HEAVY,PRTL_14521,12742,2,DIESEL,5464000,5190800,4644400,4371200,3824800,3278400,2732000,2458800,2185600,1912400,1639200,1366000,956200,812770,528301,449056,314339,VEH_MANF_141,PRTL_14521,MFT2,35000
